####################################################################################################
#....=.. ...#...... ......... #.#.#...#.#.. .. ....= .........#.......#...#.#........ .. .....#    #
### ###.#########.###########.#.# ###.#.#####.###.##### ###.###.#####.#.### # #.###.###.####### ####
# ..#=#.#.......#.. ..... #.#.. ......#.......#.... ..#...#.#.....#.. ......#.#.#.....#...# #=    ##
#.#####.### ###.###.#######.###.#######.###.#.# #####.###.#.###.###########.###.#######.#.# # ### ##
#...#.#.#. .#   =........ .. .#........ ..#.#.#.#   #.#...# #.. #.....#.............#. .# #   #   ##
# #.#.#.#.#.#.#.#.#############.#####.### #.###.### #.###.#######.###.# #########.###########=#=####
#.# . #...# #.#.#.........# #...#.#=....#.#.. #...# #.#...#.#.#...#. ...#. ...#.#.=........ # # #.##
# # #.### ###.###.#.###.#.# ###.# #.#####.#######.###.#.###.#.###.#####.###.#.#.##### #####.### #.##
#.#.#.. ....#...#=#=# #.#.# #.....#.....#...#...#.....#.#.. . ....#..... ...# #....=#...#.#.#   #.##
#.#####.#####.#########.#.###.###.###.###.#.#.###.#######.#####.#######.###.#=###.#.#.###.#######.##
#.# #...#.#...#...#.#...#.......#...#...#.#...# # ... #.......#.#.....#...#.#.# =.#.... .. ..=....##
#.###.#.#.#######.#.#####.#.#.#####.#########.# #####.#.#.#####.###.###.#######.#.###.#.#######.####
#.....#.........# #.#.....#.#.# ..... ... #.#.#     #  .#=#.....  # #.......#...#...#.#.#   # #....#
#.#.#.#####.#.###.#.#####.#.###.#####.#.# #.### #####.#########.#.# #.########### #####.# # # #.#.##
#.#.#.#   #.#.. =.......=.#.# #.#.#...#.# ..#.# # #...........#.#. .#...# #. .........# # #   #.#.##
#####.##### #####.#####.#.#######.#######.#.#.# # #.#####.#########.#######.###.#######.#######.# ##
#...#.=.#.. ....# .. .#.#.................#...#   #...#...#.#. .#... .....#.#.#.#.#........ .. .#.##
#.###.###.#######.###########.###.#######.#.#######.###.###.###.#####.###.#.#.#.#.###.###=###.###.##
#.#.... ....#.#.....# #.# #.#.#...#.......#...#...#.#.....=.. #.#.....#.#.% ..#...#...#...# #...#.##
#.#.###.#=###.###.###=#.###.#####.#.#.### #.###.###.#####.#.### #.#.# #.#.# ###.#.###########.######
#.#.#.#.#=......#.....#.... .... .#.#...#.#.#...#.....#.. #.....#.#.#.#...#...#.#...# . #.....#...##
#.#.#.#######.#######.#######.###=#######.#####.#.#######.#####.###.#######.#.#.#.#.#.#.#.#####.#.##
#.#.....#.#.... #.......#=....#.........#.=.#.#...#.... ..#.......#...#. .. #.#.#.#...#.....#...# .#
# #.#####.#.#.###.#####.#.######### ###.#####.#.#####=###.######### ###############.#####.###.#.####
#.=.#.....#.# #...#.#...#.#........=#.......#...#...#...#.#.#.#.....#.... ......#.#...#.#.#.#.# # ##
#########.###.#####.#.### #.#.###.#######.#####.###.#.#####.#.#.#.###.#.#.#######.#.###.###.#.######
#.....#.......# #. . .#...#.#.# #...#.. ....#.....#...#. .#...\.#.... #.#. .#.#.=...#.#.....=.# #  #
#=#.#.#.#########.###.#.###.#.# #.##### ###.#.# ### #####.###.#####.###.###.#.###.# #.#.#####.#.####
#.#.#.#...#.......#...#.. #.#.# #.#   #.#. ...# # #..=# ..# #...#...# #...#.#...#.#.#.. #. .# .. .##
#.#####.#####.#####.# #.#.# #####.#########.#########.### #######.### #####.#.#######.###.#.########
#... . .#.....# #.#.#...#.# ......... #=....#. .. ....... .. .#.. ..#     #.......#.......#... . ..#
###.#.###.#.#####.###.#.#####.#.#.#####.###.#.###.#####.#.##### ### #######.#####.#####.#####.###.##
#...#... .#.......#.#.#=....#.#.#.#=... . #. .#=..#.#...#.......# #.. #.#.....# #...#.==#...#.# ..##
# ###.#.###.#.#.###.#.#####.###.#####.##### ###.### ###.#.#.###.###.###.#.#.###.###.#.#####.#.######
#.# #.#.#...#.#...#...#.....#..= .#...# # ..#...# #.....#.#...#.......#...#...# ..#.#. .#.......# ##
#.# ###.#.#.####### ### #####.#####.#####.###.### #####.##### #########.#.###=#.###.#####.##### ####
#.#   #.#.# .  ...#.#.# #   #...#...#.. #...#...#   #.#.  ..#...........#...#. .#.......#.#.#.#...##
#.# #######.#####.#.#.######### #.# ###.#.####### ### # #####.#.#######.#####.###.#########.#.#.#.##
#.# #...#...#.....#.#...........#.#...#=..#.#...# #.....# #...#...#.......# #.#.......#.....# ..#..#
#.###.#.#.#.#.##### #.#.# #.#####.#.###.###.#.# # #.#########.##### ###.#.###.#####.#####.#####.#.##
#... .#...#.#..... ...# #.#. .....#......... .#.# #.... #.. ....#.#...# #.....#   #...#...#. ...#.##
###.###=###.#####.#.#.#=#######.###.#.# ###.#######.#####.###.###.###########.##### #.### #.#####.##
#...# #...#.#.# #.#.#.#.#.#.. #.# #.#.#...#.#...#...#...#...#... ...#.#...# ....... #.... #.# # ..##
# #.#####.###.# #.#.#.###.###.# ###.#######.###.# ### #.#.#######.#.#.#.###.###.###############.####
# # ..=.....#.# #.#.# ..#. ...#.....# #.#..... ...#...#.......#.#.# ......#...#.#... ...  =.......##
###.#.###.###.###.#.#.#####.#.###.#.###.#####.#####.###.###.###.###.###.#.###.# ###.#############.##
#...#.#.....#.....#.#.#.#...#.=.# #.....#= ...... ..#.#.# # ....#.....#.#. .#.#.......#...#.... ..##
###.###.###.#.####### #.#####.#.#####.#.#.# #####.###.# #####.#.###.# #.###.#.#.#####.#.#.###.###.##
#.#.# #.# #...# #...#.......#.#.....# #.#.#.#. .#.# ....#.....#.#.#.#.#= .#.#.#.#. .....#...#.#...##
#.#.###.#####.# #.#.#.#####.#.#.#.#.###.#.#.# ###.#.#####.#######.#######.#####.#.###.#.###.#.######
#.#... .#..=#.# #.#. .# #.#...#.#.#.#.....#.. ..#.#.#...#.....#.#..... .......#.#.#.#.#.#...#.#.# ##
# #.#####.###.# ##### ###.#.###.#########.#######.#.#.#.#.### #.###.#######.#####.#.#####.#.#.# ####
#. .......#. .# #.#... ...#.#.. ..#. .........#...#.#.#...==#.. ..# #...#.....#...#.....#.#.#.#.=.##
#.###.### ###.###.#.#.###=###.###########.#######.#.#########.###.#.#.#.#.#.# #########.#.###.###.##
#...#...#......... .#.#.#..=# ... ..#.... . ..# #.# #.. ... #.#...#...#.#.#.#.....=.#.#.. ..#.....##
#####.#####.#########.#.#.###.###.### ###.###.###.#.#.#####.###.###########.#.#.###.#.#.###.#.###.##
#..... ...#...#...#.# #.#.  # ..#.. #...#.#.#.#.= #.....# ..#.........#.#=. #.#.#.....#...#.#...# .#
#.##### ### #.###.#.# #.###.######### #.###.#.###.#########.#####.#.###.#.# #.###.### #=#.#######.##
#.... #.# #.# #.....#. .# #  .#.......#.# #.#.=.#.#   #.#.#.......#.. ..#.#.#.#.....#.#=#. .# # #.##
#.#.#######.###.#.#########.#.#.#.#####.###.#.###.#####.#.###.#.#####.#.###.#.#######.####### # ####
#.#.....#.#.....#.... ..#...#...#.# #...#...#. .#.#.........#.#.. #...#.# #.#.... #.....#     #    #
###.#.### ###.#.#####.#.#.#.#.#.#.### #.#.#####.#.###.#####.#########.#######.#####.#.##### # # ####
#...#. =......#.# #.#.# ..#.#.#.# ....#...#.......... ....#.#.............#...#.....# ..#   #  =#  #
# #.#.#########.###.###.###########.###.#####.###.###########.#.##### #####.#.#######.##### ### ####
#.#.#.....# #.. ..#...#...#. .........#. . ...#...#...#...#...# . #....... .#...#.#.....#     #   ##
#.#####.#######.# #.#.###.#####.###########.#.###.###.#.#.#.#######.#######.#.### #.######### ### ##
# #.# #.#...#...#...#. .#. ...#.......#.#.#.#=..#=..#...#..... .#.......#...#.# #...#...#...# #   ##
#.#.###.###.#.##### #####.#########.#.# #.######### #####.#.#############.#.##### ###.###.##########
#...#.# #.... # # ....#...#... ...#.# #...#...........#...#.. ....#...=.#.#.#...#......... .#...#.##
###.#.#.#.###.###.#.###.###.#######.#####.###.#########.#.#.#####.#####.#######.###.#.#.#####.###.##
#.#.#...#.#.. ....#...  #.. #...#.#.. ....# #.... .... .#.#.... #.#.#.#...#.#. ... .# # #.# #......#
#=#.#.####### ####### ###.#.###.# ###.#.###=# #########.#####.###.#.#.###.#.#.###.###.###.###.#.####
#.. ...... .....# #.......#.#.#.....#.#...# #..... .# #.#.....# #...... ..#.#...#.# #.#.....#.#.#  #
###.### # ###.### ###.#####.#.### #.###.#.###.####### # ###.#####.#########.#.#######.#.#.#.#.######
#.....#.#.# #.. #   #.#   #.. ....# #...#.. ......#.# #.# #.... ..#.. ....... ... . ..#.#.# ..#.#.##
#.#######.# ###.#####.#######.#######.#.######### # ###.###.#####.#.# #.#####.#####.#.###.#.###.#.##
#.#.#...#.# #.........#.......... ..#.#..=..#.. .......... .. . #...# #.#.#...#.....#...#.#....  .##
#.#.#.#########.###.#.###.#.###.#.#.#.#####.##### #######.#.#########.###.# ###.#.###.#.###.########
#.#. .......#...#...#.....#...#=#.#.#...# #.....#.# . # ..#.....#...#...#.#=# # #.# #.# #.........##
#.###.#.###.#######.#####.#.#####.#########.###.#.#.#####.#########.#.#.#.#.# ###.###.###.###.#.####
#.=.#.#...# ..... .. .# #.#.#...#.......#...#...#.#.....#.#.......#...#.#...# #...... ....#...#.#.##
###.#.# ###########.###.#.#.#.###.###.#####.###.#####.###.##### #.### ###.#####.#.#####.#####.#.#.##
#..=..#...#.. ....#...#. .#.....#.#...#.#...# . ..#. .#.......# # #.#.#.#.......#.#.#.#...#.#.#  .##
#.#######.###.###.#.###.############# #.###.#.###.###.#########.#.# ###=#####.#####.#.#####.###.####
# #...#.........# #.#.. ....#.#....=#.#.....# ..#. . .... #.....#.. ..#.#. ....... ...#...#..=#.# ##
### #.#.#########.#########.#.#.###.#.###.#.#########.###=#.#####.#####.#######.#####.###.#.#.### ##
#.#.#.#... .#...#=..... ..# #...#.# #...#.#...#... ...# #.......#...#...# #.. . #   # ..#...# #    #
#.#.#.#.#####.###.# ###=###.#####.#.###.### #####.#######.#####.#####.#########=#####.###.#.##### ##
#.#.#.....#.=...#.#.#...# #.# #...#.=...........#..........=# ... .... ...#.... ... . ....#.#...# ##
#.#.###.###.#.#####.#.#.###.###.#.#.###.#####.###=###.#.#######.###.#####.#.#.#.###.#.#####.#.######
#...#...#. .# #.#.#.#.#....... .#...# #.#...#.#...#.#.#.# # #.#.#.#.# #.. #.#.#.# #.#...#.#=..#...##
###.#.#.#.#.###.#.#.#############.##### #.###.###.#.#.### # #.#.#.#####.#.#.#######.##### #.#.###.##
# ..# #.#.#.......#. .#. .#.....#...#.......#.#.#...#...#   #.....=.#.. #.#.....#.#.# #... .#.....##
###.#.###.#.###.#####.#.###.###.#.#######.###.#.#.### #.### #####.###.#.#.#.#.###.#.###.#####.######
#.#.#.....#.#.# ..# #.........#.#.. =.... ..#.#...# #.#.#   # #.#.#...#.#...#.. ............#..=# ##
#.#.#########.#.#.###.#######.#########.#.#####.### ##### ### #.#.#####.##### #####.#####.###.#.####
#....=# #.......# . ..#   #...# # #   # #.....#.#   #       # #.....#  . .# #... .#.#   # # #.#...##
#####.# ##################### # # #######.####### ########### #.#######.#####.####### #########.####
####################################################################################################
