################
#.#.#.......#  #
#.#.###.#.######
#...# ..#.#.%..#
#.#.#.#.### ####
#.#.. #=. ....##
#.###.#####=####
#...#.#.#.#.#  #
###.###.#.# # ##
#=..#...# # # ##
#.#.#.#.#.### ##
#.#...#...#  =##
#######\########
#     #.#     ##
### ###.### ####
################
